11111111111
10000000001
1000C001001
10000E00001
101001P0001
10000001001
11111111111
