11111111111
10E00000001
1000C001001
10000000001
101001P0001
10000001001
11111111111
